NO ./assets/textures/north.xpm
SO ./assets/textures/south.xpm
EA ./assets/textures/east.xpm
WE ./assets/textures/west.xpm

F 220,100,0
C 225,30,0

        111111111111
        100000000001
        101111111101
        1010000000011
111111111010001111101
100000000000001000001
100000011111111000001
100000000000000000001
101111111111111110101
1000000000000000000N1
111111111111111111111