NO ./assets/textures/dirt_road.xpm
SO ./assets/textures/dehydrated_earth.xpm
EA ./assets/textures/dirty_mossy_tiles.xpm
WE ./assets/textures/green_wall_rocks.xpm

F 42,42,220
C 42,42,42

11111   111111111111111111111
10S01   1000000000000000000011
10001111100000000000000000011
1000000000001111111111000111
1000000000001       110011
1111111110001      110011
        10001     110011
        10001    1100111111111
        10001111110000000000011
        10000000000000000000001
        11111111111111111111111