NO ./textures/
SO ./textures/
WE ./textures/
EA ./textures/

F  000, 000, 00
C  225,30,0

111111
100101
101001
1100N1
111111